Label,Notation,Parent Notation,Sort Priority
National,national,,
02N,02n,,
09C,09c,,
07L,07l,,
07M,07m,,
02P,02p,,
99E,99e,,
02Q,02q,,
11E,11e,,
06F,06f,,
15A,15a,,
07N,07n,,
15E,15e,,
00Q,00q,,
00R,00r,,
00T,00t,,
02W,02w,,
02R,02r,,
07P,07p,,
09D,09d,,
15C,15c,,
07Q,07q,,
14Y,14y,,
00V,00v,,
02T,02t,,
06H,06h,,
07R,07r,,
04Y,04y,,
09E,09e,,
99F,99f,,
09A,09a,,
00X,00x,,
07T,07t,,
09G,09g,,
03V,03v,,
05A,05a,,
09H,09h,,
07V,07v,,
00C,00c,,
09J,09j,,
15M,15m,,
15N,15n,,
02X,02x,,
11J,11j,,
05C,05c,,
00D,00d,,
07W,07w,,
06K,06k,,
15D,15d,,
01A,01a,,
03W,03w,,
02Y,02y,,
05D,05d,,
09L,09l,,
09F,09f,,
01C,01c,,
07X,07x,,
10K,10k,,
02M,02m,,
11M,11m,,
06M,06m,,
03A,03a,,
01E,01e,,
08A,08a,,
09N,09n,,
01F,01f,,
03D,03d,,
08C,08c,,
08D,08d,,
03E,03e,,
08E,08e,,
00K,00k,,
09P,09p,,
08F,08f,,
05F,05f,,
06N,06n,,
01D,01d,,
99K,99k,,
08G,08g,,
09X,09x,,
07Y,07y,,
03F,03f,,
06L,06l,,
10L,10l,,
08H,08h,,
11N,11n,,
08J,08j,,
01J,01j,,
08K,08k,,
15F,15f,,
04C,04c,,
08L,08l,,
03T,03t,,
04D,04d,,
99A,99a,,
06P,06p,,
14L,14l,,
04E,04e,,
09W,09w,,
08R,08r,,
06Q,06q,,
04F,04f,,
01K,01k,,
04G,04g,,
04H,04h,,
13T,13t,,
08M,08m,,
01H,01h,,
00J,00j,,
06T,06t,,
99M,99m,,
03H,03h,,
10J,10j,,
03J,03j,,
03K,03k,,
06V,06v,,
05G,05g,,
99C,99c,,
09Y,09y,,
00L,00l,,
06W,06w,,
04K,04k,,
04L,04l,,
04M,04m,,
00Y,00y,,
10Q,10q,,
10R,10r,,
08N,08n,,
05J,05j,,
08P,08p,,
03L,03l,,
04N,04n,,
01G,01g,,
05L,05l,,
03M,03m,,
03N,03n,,
05N,05n,,
11X,11x,,
01R,01r,,
05Q,05q,,
10V,10v,,
10A,10a,,
99D,99d,,
06Y,06y,,
01T,01t,,
00M,00m,,
00N,00n,,
05R,05r,,
04Q,04q,,
05T,05t,,
10X,10x,,
99G,99g,,
01V,01v,,
08Q,08q,,
01X,01x,,
05V,05v,,
01W,01w,,
05W,05w,,
00P,00p,,
99H,99h,,
10C,10c,,
08T,08t,,
10D,10d,,
12D,12d,,
01Y,01y,,
05X,05x,,
10E,10e,,
07G,07g,,
08V,08v,,
02A,02a,,
03Q,03q,,
02D,02d,,
03R,03r,,
05Y,05y,,
08W,08w,,
08X,08x,,
02E,02e,,
05H,05h,,
02F,02f,,
07H,07h,,
11A,11a,,
99J,99j,,
02G,02g,,
04V,04v,,
08Y,08y,,
07J,07j,,
07K,07k,,
02H,02h,,
99N,99n,,
12F,12f,,
06A,06a,,
06D,06d,,
03X,03x,,
03Y,03y,,
04J,04j,,
99P,99p,,
99Q,99q,,
04R,04r,,
10Y,10y,,
13P,13p,,
04X,04x,,
10G,10g,,
11H,11h,,
10H,10h,,
02V,02v,,
03G,03g,,
03C,03c,,
10M,10m,,
10N,10n,,
11T,11t,,
10T,10t,,
05P,05p,,
12A,12a,,
10W,10w,,
11C,11c,,
11D,11d,,
00W,00w,,
01M,01m,,
01N,01n,,
00F,00f,,
00G,00g,,
00H,00h,,
